000000000
011101110
G1110111G
011101110
011101110
0000x0000