G0000000G
111101111
111101111
111101111
111101111
111x00111