G0000000G
111101111
111101111
111101111
111101111
1x0000001